维生素E缺乏病	维生素E缺乏病
短P-R综合征	短P-R综合征
横膈下结肠嵌入综合征	横膈下结肠嵌入综合征
小儿葡萄状肉瘤	小儿葡萄状肉瘤
先天性胸骨后膈疝	先天性胸骨后膈疝
骨良性纤维组织细胞瘤	骨良性纤维组织细胞瘤
小汗腺痣	小汗腺痣
老年人结肠憩室	老年人结肠憩室
铁中毒	铁中毒
副肿瘤性斜视性眼肌阵挛-肌阵挛	副肿瘤性斜视性眼肌阵挛-肌阵挛
硬红斑	硬红斑
色汗症	色汗症
小儿热带嗜酸性粒细胞增多症	小儿热带嗜酸性粒细胞增多症
拉肚子	拉肚子
SAS	SAS
乙状结肠间疝	乙状结肠间疝
幼淋巴细病胞白血	幼淋巴细病胞白血
妊娠合并血栓性疾病	妊娠合并血栓性疾病
甲内型甲真菌病	甲内型甲真菌病
急性肠胃炎	急性肠胃炎
颞下颌关节炎	颞下颌关节炎
急性化脓性胆管炎	急性化脓性胆管炎
外耳道炎	外耳道炎
细支气管肺泡癌	细支气管肺泡癌
小肠扭转	小肠扭转
胃损伤	胃损伤
肿胀	肿胀
干燥综合征神经系统损害	干燥综合征神经系统损害
咽喉部外伤	咽喉部外伤
胸主动脉夹层动脉瘤	胸主动脉夹层动脉瘤
遗传性纤维蛋白原缺乏症	遗传性纤维蛋白原缺乏症
毛囊皮脂腺囊性错构瘤	毛囊皮脂腺囊性错构瘤
成人型慢性粒细胞白血病	成人型慢性粒细胞白血病
巴西紫热	巴西紫热
外阴隆凸性皮肤纤维肉瘤	外阴隆凸性皮肤纤维肉瘤
皮肤癌	皮肤癌
药物反应性甲病	药物反应性甲病
卵巢成熟畸胎瘤	卵巢成熟畸胎瘤
睑皮松垂症	睑皮松垂症
失认症	失认症
痰湿阻肺	痰湿阻肺
老年人糖尿病性心脏病	老年人糖尿病性心脏病
小儿注意缺陷障碍	小儿注意缺陷障碍
二水焦磷酸钙结晶沉积症	二水焦磷酸钙结晶沉积症
支气管炎	支气管炎
颈椎过伸性损伤	颈椎过伸性损伤
胃心综合征	胃心综合征
肛门周围癌	肛门周围癌
老年人嗜铬细胞瘤危象	老年人嗜铬细胞瘤危象
感染性疾病所致贫血	感染性疾病所致贫血
乳头状汗腺腺瘤	乳头状汗腺腺瘤
骨髓纤维化	骨髓纤维化
一度房室传导阻滞	一度房室传导阻滞
肾脏损伤	肾脏损伤
真菌过敏症	真菌过敏症
先天性喉蹼	先天性喉蹼
旋前圆肌综合征	旋前圆肌综合征
先天性肛门直肠狭窄	先天性肛门直肠狭窄
地图舌	地图舌
过敏性休克	过敏性休克
茎突综合征	茎突综合征
磨牙	磨牙
滑膜肉瘤	滑膜肉瘤
外耳道异物	外耳道异物
十二指肠壅积症	十二指肠壅积症
雅皮士流感	雅皮士流感
软组织肿瘤	软组织肿瘤
角层下脓疱性皮肤病	角层下脓疱性皮肤病
窦性心动过缓	窦性心动过缓
急性右侧心力衰竭	急性右侧心力衰竭
乳头皲裂	乳头皲裂
慢性硬脑膜下血肿	慢性硬脑膜下血肿
胃肠型食物中毒	胃肠型食物中毒
马牙	马牙
口腔白斑	口腔白斑
上矢状窦血栓性静脉炎	上矢状窦血栓性静脉炎
尺桡骨骨干双骨折	尺桡骨骨干双骨折
胸椎间盘突出症	胸椎间盘突出症
下颈椎不稳症	下颈椎不稳症
葡萄球菌感染	葡萄球菌感染
急性尿道综合征	急性尿道综合征
家族性黏液血管纤维瘤	家族性黏液血管纤维瘤
小儿周期性低血钾性麻痹	小儿周期性低血钾性麻痹
复发性外阴阴道念珠菌病	复发性外阴阴道念珠菌病
氟骨症	氟骨症
营养障碍性多发性神经病	营养障碍性多发性神经病
老年人肝硬化	老年人肝硬化
先天性肠旋转不良	先天性肠旋转不良
慢性单纯性鼻炎	慢性单纯性鼻炎
阴囊湿疹	阴囊湿疹
小儿骨软骨瘤	小儿骨软骨瘤
膈先天性缺损	膈先天性缺损
面红和面红恐惧症	面红和面红恐惧症
乳房湿疹	乳房湿疹
肩关节结核	肩关节结核
恶性肾肿瘤	恶性肾肿瘤
胆碱能性荨麻疹	胆碱能性荨麻疹
坏死性筋膜炎	坏死性筋膜炎
老年人黏液性瓣膜病	老年人黏液性瓣膜病
眼睑热性疱疹	眼睑热性疱疹
老烂腿	老烂腿
急性腰扭伤	急性腰扭伤
虫霉病	虫霉病
视网膜静脉周围炎	视网膜静脉周围炎
桡骨颈骨折和桡骨头骨骺分离	桡骨颈骨折和桡骨头骨骺分离
反流性食管炎	反流性食管炎
倾倒综合征	倾倒综合征
小儿黏多糖贮积症	小儿黏多糖贮积症
躁狂症	躁狂症
慢性纵隔炎	慢性纵隔炎
复发性线性棘层松解性皮肤病	复发性线性棘层松解性皮肤病
房室折返性心动过速	房室折返性心动过速
妊娠合并梅毒	妊娠合并梅毒
克罗恩病	克罗恩病
腹壁纤维肉瘤	腹壁纤维肉瘤
原发性阿米巴脑膜脑炎	原发性阿米巴脑膜脑炎
肛管直肠恶性黑色素瘤	肛管直肠恶性黑色素瘤
泪囊炎	泪囊炎
小儿变形性肌张力障碍	小儿变形性肌张力障碍
脑积水	脑积水
酒精肝	酒精肝
小儿肥胖症	小儿肥胖症
十二指肠溃疡	十二指肠溃疡
发疱性甲虫皮炎	发疱性甲虫皮炎
钩虫皮炎	钩虫皮炎
大肠癌	大肠癌
皮肌炎与多发性肌炎	皮肌炎与多发性肌炎
脑室炎	脑室炎
胃纳呆滞	胃纳呆滞
小儿白血病	小儿白血病
Y染色体遗传病	Y染色体遗传病
农药中毒	农药中毒
灼痛	灼痛
胫骨结节骨软骨病	胫骨结节骨软骨病
创伤性骨髓炎	创伤性骨髓炎
慢性淋巴细胞性甲状腺炎	慢性淋巴细胞性甲状腺炎
慢性劳损性颈背部筋膜纤维织炎	慢性劳损性颈背部筋膜纤维织炎
胃神经纤维瘤	胃神经纤维瘤
婴儿脑积水	婴儿脑积水
泌乳素瘤	泌乳素瘤
阑尾肿瘤	阑尾肿瘤
急性上颌窦炎	急性上颌窦炎
棘突骨折	棘突骨折
呃逆症	呃逆症
细菌性痢疾	细菌性痢疾
农药中毒所致的精神障碍	农药中毒所致的精神障碍
胸部丝虫病	胸部丝虫病
子宫恶性肿瘤	子宫恶性肿瘤