余热未清证	余热未清证
胞宫虚寒证	胞宫虚寒证
肌肤失养证	肌肤失养证
胆气虚热证	胆气虚热证
外伤瘀滞证	外伤瘀滞证
肝胃郁热证	肝胃郁热证
虚陷证	虚陷证
拔毒丹	拔毒丹
经气痞塞证	经气痞塞证
邪恋耳窍证	邪恋耳窍证
热盛动血证	热盛动血证
虫湿壅络证	虫湿壅络证
痰浊凝聚声门证	痰浊凝聚声门证
肝风痰浊证	肝风痰浊证
痰湿蕴肺证	痰湿蕴肺证
老鼠瓜	老鼠瓜
湿热蒸舌证	湿热蒸舌证
风热闭肺证	风热闭肺证
莱菔酒	莱菔酒
金纽子	金纽子
白毛藤	白毛藤
杠香藤	杠香藤
肝中寒证	肝中寒证
虚火上炎证	虚火上炎证
肾气虚证	肾气虚证
湿毒中阻证	湿毒中阻证
禀赋不足证	禀赋不足证
脾失健运证	脾失健运证
牛黄桂枝丸	牛黄桂枝丸
胃肠积热证	胃肠积热证
胃火炽盛证	胃火炽盛证
肝郁气逆证	肝郁气逆证
邪在少阳证	邪在少阳证
上焦湿热证	上焦湿热证
气虚痰结证	气虚痰结证
加减代赭旋覆花汤	加减代赭旋覆花汤
肝瘀痰结证	肝瘀痰结证
胞宫痰湿阻滞证	胞宫痰湿阻滞证
肺热熏鼻证	肺热熏鼻证
气虚不摄证	气虚不摄证
胃热炽盛证	胃热炽盛证
冬虫夏草酒	冬虫夏草酒
牛车肉	牛车肉
命门水亏证	命门水亏证
阴闭证	阴闭证
脾胃阴虚证	脾胃阴虚证
寒滞肝脉证	寒滞肝脉证
活血止疼汤	活血止疼汤
毒燔气营证	毒燔气营证
湿热疫毒内陷证	湿热疫毒内陷证
秘授万灵一粒九转还丹	秘授万灵一粒九转还丹
胃热肠寒证	胃热肠寒证
血瘀成积证	血瘀成积证
石荠苧	石荠苧
刺石榴	刺石榴
瘀血犯腰证	瘀血犯腰证
寒毒内闭证	寒毒内闭证
\ufeff白鲜皮	\ufeff白鲜皮
肾阴虚火旺证	肾阴虚火旺证
任脉不通证	任脉不通证
肠风伤络证	肠风伤络证
血虚阳浮证	血虚阳浮证
肺郁水停证	肺郁水停证
血虚鼻窍失养证	血虚鼻窍失养证
肝热血瘀证	肝热血瘀证
马尾连	马尾连
热毒壅结证	热毒壅结证
昆明堵喇	昆明堵喇
槐耳	槐耳
足太阳膀胱经证	足太阳膀胱经证
阳虚饮停证	阳虚饮停证
张真君茯苓丸	张真君茯苓丸
水气凌心证	水气凌心证
痰热结胸证	痰热结胸证
肝阳不足证	肝阳不足证
气血亏虚证	气血亏虚证
下焦虚冷证	下焦虚冷证
瘀热上蒙证	瘀热上蒙证
水禾麻	水禾麻
阴虚毒盛证	阴虚毒盛证
湿热发黄证	湿热发黄证
心热血瘀证	心热血瘀证
气血两虚动风证	气血两虚动风证
姜葱饮	姜葱饮
心神劳伤证	心神劳伤证
阴虚毒恋证	阴虚毒恋证
肾虚毒泛证	肾虚毒泛证
湿重于热证	湿重于热证
羊髓	羊髓
寒凝心脉证	寒凝心脉证
啄木散	啄木散
气结血瘀证	气结血瘀证
虫邪犯肺证	虫邪犯肺证
君臣洗药方	君臣洗药方
心阳虚证	心阳虚证
痰瘀化热证	痰瘀化热证
鼻伤骨折证	鼻伤骨折证
胞宫瘀阻证	胞宫瘀阻证
胃寒虫扰证	胃寒虫扰证
心胆气虚证	心胆气虚证
血虚津亏证	血虚津亏证
孙武散	孙武散
小肠实热证	小肠实热证
气虚耳窍失充证	气虚耳窍失充证
胃阳虚气滞证	胃阳虚气滞证
阳虚水泛证	阳虚水泛证
液亏证	液亏证
肠道瘀滞证	肠道瘀滞证
肝胆气滞证	肝胆气滞证
猪髓膏	猪髓膏
风热袭络证	风热袭络证
脾胃阳虚气滞证	脾胃阳虚气滞证
肝血虚动风证	肝血虚动风证
肝气犯胃证	肝气犯胃证
寒湿伤肾证	寒湿伤肾证
野冬青皮	野冬青皮
风热俱盛证	风热俱盛证
血热妄行证	血热妄行证
湿郁三焦证	湿郁三焦证
野葡萄根1	野葡萄根1
火毒蕴结证	火毒蕴结证
津气欲脱证	津气欲脱证
胞宫湿热证	胞宫湿热证
风寒痹阻证	风寒痹阻证
蚕豆壳	蚕豆壳
薤白	薤白
气虚血瘀证	气虚血瘀证
肝郁肾虚证	肝郁肾虚证
马蹬草	马蹬草
邪在气营证	邪在气营证
制疳丸	制疳丸
甘草	甘草
心肺郁热证	心肺郁热证
气血上逆证	气血上逆证
跳骨丹	跳骨丹
血虚肠燥证	血虚肠燥证
风湿挟毒证	风湿挟毒证
草金杉	草金杉
脾胃气阴两虚证	脾胃气阴两虚证
肠道实热证	肠道实热证
暑入心营证	暑入心营证
乌蛇皮	乌蛇皮
三白草根	三白草根
天花粉	天花粉
痰湿蒙蔽证	痰湿蒙蔽证
暑热浸淫证	暑热浸淫证
痰饮停胃证	痰饮停胃证
胃虚气滞证	胃虚气滞证
少阴头痛证	少阴头痛证
饮停中耳证	饮停中耳证
气机郁滞证	气机郁滞证
痰结毒聚证	痰结毒聚证
阳虚寒凝证	阳虚寒凝证
八厘丸	八厘丸
风火犯齿证	风火犯齿证
痰热瘀肺证	痰热瘀肺证
表里俱实证	表里俱实证
湿热火毒壅盛证	湿热火毒壅盛证
肝胆湿热证	肝胆湿热证
风寒湿痹阻证	风寒湿痹阻证
邪郁少阳证	邪郁少阳证
膀胱湿热证	膀胱湿热证
风毒犯表证	风毒犯表证
延生膏	延生膏
肝胆火热证	肝胆火热证
少阴热化证	少阴热化证
瘀血阻膈证	瘀血阻膈证
食滞痰阻证	食滞痰阻证
心肺实热证	心肺实热证
痰毒瘀结证	痰毒瘀结证
厥阴头痛证	厥阴头痛证
五爪龙	五爪龙
风毒入里证	风毒入里证
油发散	油发散
湿毒蕴结证	湿毒蕴结证
羌活胜湿汤	羌活胜湿汤
肝阴虚证	肝阴虚证
脾胃实热犯唇证	脾胃实热犯唇证
气轮阴虚证	气轮阴虚证
海金散	海金散
燥干清窍证	燥干清窍证
食滞胃脘证	食滞胃脘证
心肾不交证	心肾不交证
一年蓬	一年蓬
热闭心神证	热闭心神证
胃热滞脾证	胃热滞脾证
暑入心包证	暑入心包证
紫花鱼灯草	紫花鱼灯草
清络饮加甘桔甜杏仁麦冬汤	清络饮加甘桔甜杏仁麦冬汤
湿热蒸口证	湿热蒸口证
热极伤阴证	热极伤阴证
肺经风热证	肺经风热证
肾虚水泛证	肾虚水泛证
豆腐浆	豆腐浆
经脉瘀阻证	经脉瘀阻证
血虚感冒证	血虚感冒证
肺肾气虚证	肺肾气虚证
暑湿犯肺证	暑湿犯肺证
食浊阻滞证	食浊阻滞证
莲子	莲子
瓣蕊唐松草	瓣蕊唐松草
驱暑建中汤	驱暑建中汤
肉轮热毒证	肉轮热毒证
阴阳两虚证	阴阳两虚证
风热痹阻证	风热痹阻证
肝气虚证	肝气虚证
肝胆热毒证	肝胆热毒证
食毒痹阻经络证	食毒痹阻经络证
活血舒筋汤	活血舒筋汤
脾虚痰凝证	脾虚痰凝证
风痰入络证	风痰入络证
气滞痰凝咽喉证	气滞痰凝咽喉证
太阳痞证	太阳痞证
心火上炎证	心火上炎证
血瘀气逆证	血瘀气逆证
气郁伤肺证	气郁伤肺证
治浊子午丸	治浊子午丸
阴虚痰恋证	阴虚痰恋证
紫霜圆	紫霜圆
野马蹄草	野马蹄草
气陷证	气陷证
卫气虚证	卫气虚证
中焦寒湿证	中焦寒湿证
任督亏虚证	任督亏虚证
肺燥津伤证	肺燥津伤证
气轮风热证	气轮风热证
湿郁化热证	湿郁化热证
石阻气闭证	石阻气闭证
伤酒泄泻证	伤酒泄泻证
地榆	地榆
湿热蒸齿证	湿热蒸齿证
肺阳虚衰证	肺阳虚衰证
血轮热毒证	血轮热毒证
瘀阻胃络证	瘀阻胃络证
痰火内扰证	痰火内扰证
风痰恋肺证	风痰恋肺证
湿邪浸渍证	湿邪浸渍证
风燥伤肺证	风燥伤肺证
解毒犀黄丸	解毒犀黄丸
水湿内蕴证	水湿内蕴证
